################
#X#   @        #
# #       C    #
# #          # #
# #          # #
# #      S   # #
# #   G      # #
# #          # #
# #     O    # #
# #          # #
# #     V    # #
# #          # #
# #          # #
# ############ #
#              #
################
