################
#X#        C   #
# #     @      #
# #          # #
# #          # #
# #          # #
# #          # #
# #          # #
# #   D      # #
# #          # #
# #          # #
# #          # #
# #          # #
# ############ #
#              #
################
